Decline = Decline
Can't Start Game = Can't Start Game
Confirm Password = Confirm Password
Logged out = Logged out
Please re-type your password. = Please re-type your password.
Hint = Hint
Please Pass The Device = Please Pass The Device
Next Round = Next Round
Review = Review
Multiplayer = Multiplayer
Account = Account
Please Register = Please Register
Two Players One Device = Two Players One Device
Please ensure that the Zing! switch is ON in Settings -> Facebook. = Please ensure that the Zing! switch is ON in Settings -> Facebook.
Game Type = Game Type
Location = Location
High Scores = High Scores
Multiplayer Game Setup = Multiplayer Game Setup
When you are ready to resume, you will be presented with a new question with no time or score penalty. = When you are ready to resume, you will be presented with a new question with no time or score penalty.
Sign-in with Facebook = Sign-in with Facebook
Email = Email
Today = Today
My Games = My Games
Username = Username
Game is Paused = Game is Paused
OK, I'm Ready = OK, I'm Ready
Error fetching High Scores = Error fetching High Scores
Resume = Resume
All Time = All Time
This Week = This Week
Error fetching challenges = Error fetching challenges
By Username = By Username
End Game = End Game
Rematch = Rematch
Settings updated. = Settings updated.
Log In = Log In
Gender = Gender
Error finding facebook user user = Error finding facebook user user
More Info = More Info
Password = Password
Setup = Setup
Single Player = Single Player
username = username
Facebook Login Permission Error = Facebook Login Permission Error
About = About
Passwords Do Not Match = Passwords Do Not Match
Success = Success
Settings = Settings
You have been logged out. = You have been logged out.
Log Out = Log Out
Age = Age
Register = Register
Challenge Accepted! = Challenge Accepted!
Begin = Begin
Error uploading score = Error uploading score
Begin Game = Begin Game
Random Opponent = Random Opponent
Could not save your account information. = Could not save your account information.
Game Over! = Game Over!
Review Mistakes = Review Mistakes
Done = Done
Round = Round
Successfully registered as: = Successfully registered as:
Facebook Friend = Facebook Friend
OK = OK
It is time for your opponent to take their turn. Please pass the device to the other player. = It is time for your opponent to take their turn. Please pass the device to the other player.
Setting Update Error = Setting Update Error
Skip = Skip
Error finding user = Error finding user
Error creating challenge = Error creating challenge
Back = Back
Accept = Accept
Facebook Login Error = Facebook Login Error
Facebook Error = Facebook Error
Forfeit Round = Forfeit Round
Too many wrong answers. = Too many wrong answers.
Registration Error = Registration Error
Home = Home
No Zing! account for = No Zing! account for
Current Games = Current Games
Create Account = Create Account
Page = Page
Loading... = Loading...
Quiz = Quiz
Thanks for completing the survey = Thanks for completing the survey
Thanks for leaving feedback = Thanks for leaving feedback
Please try again. = Please try again.
Error fetching challenge details = Error fetching challenge details
Save = Save
Load More... = Load More...
You must have register an account to choose facebook friends = You must have register an account to choose facebook friends
The many benefits of registration = The many benefits of registration
Or = Or
Can't find facebook friends = Can't find facebook friends
Multiplayer Game Guide = Multiplayer Game Guide
Skip = Skip
Turn off music = Turn off music
Turn on music = Turn on music