Decline = انصراف
Cant Start Game = نمی‌تواند بازی را شروع کند
Confirm Password = تایید رمز عبور
Logged out = خارج شدید
Please re-type your password. = لطفا رمز عبور را مجددا تایپ کنید
Hint = راهنمایی
Please Pass The Device = دستگاه را به نفر بعدی بدهید
Next Round = مرحله بعد
Review = مرور
Multiplayer = بازی چند نفره
Account = حساب
Please Register = لطفا ثبت نام کنید
Two Players One Device = بازی دو نفره با یک دستگاه
Please ensure that the Zing! switch is ON in Settings -> Facebook. = لطفا مطمئن شوید که گزینه Zing در تنظیمات فیسبوک روشن است Settings -> Facebook
Game Type = نوع بازی
Location = مکان
High Scores = بالاترین امتیازها
Multiplayer Game Setup = تنظیمات بازی چند نفره
When you are ready to resume, you will be presented with a new question with no time or score penalty. = هر وقت برای ادامه بازی آماده باشید، یک سوال جدید بدون جریمه زمانی یا امتیازی نمایش داده می شود
Sign-in with Facebook = ورود از طریق فیسبوک
Email = ایمیل
Today = امروز
My Games = بازی‌های من
Username = شناسه کاربری
Game is Paused = بازی موقتا متوقف شده
Error fetching High Scores = خطا در بارگذاری بالاترین امتیازها
Resume = ادامه بازی
All Time = همه زمان ها
This Week = این هفته
Error fetching challenges = خطا در یافتن اطلاعات رقبا
By Username = با شناسه کاربری
End Game = بازی را تمام کن
Rematch = مسابقه مجدد
Settings updated. = تنظیمات به روز شد
Log In = ورود
Gender = جنسیت
Error finding facebook user user = خطا در پیدا کردن کاربر از طریق فیسبوک
More Info = اطلاعات بیشتر
Password = رمز عبور
Setup = ایجاد و تنظیم برنامه
Single Player = بازی تک نفره
username = شناسه کاربری
Facebook Login Permission Error = خطای اجازه ورود به فیسبوک
About = درباره
Passwords Do Not Match = رمزهای عبور یکسان نیست
Success = موفقیت
Settings = تنظیمات
You have been logged out. = شما از سیستم خارج شدید
Log Out = خروج
Age = سن
Register = ثبت نام
Challenge Accepted! = رقیب قبول کرد!
Begin = شروع
Error uploading score = خطا در بارگذاری امتیاز
Begin Game = بازی را شروع کنید
Random Opponent = یا بخت یا اقبال!
Could not save your account information. = ذخیره اطلاعات شما با موفقیت انجام نشد
Game Over! = سوختی!
Review Mistakes = بررسی جواب‌های غلط
Done = انجام شد
Round = مرحله
Successfully registered as: = با موفقیت ثبت نام کردید با نام: 
Facebook Friend = دوست فیسبوکی
OK = قبول
It is time for your opponent to take their turn. Please pass the device to the other player. = حالا نوبت رقیب شماست که بازی کند.  لطفا دستگاه را به نفر بعدی بدهید.
Setting Update Error = خطا در به روزرسانی تنظیمات
Skip = رد کن
Error finding user = خطا در پیدا کردن کاربر
Error creating challenge = خطا در ایجاد مسابقه
Back = قبلی
Accept = قبول
Facebook Login Error = خطا در ورود به فیسبوک
Facebook Error = خطای فیسبوک
Forfeit Round = مرحله را نیمه کاره بگذار
Too many wrong answers. = زیادی جواب غلط دادید!
Registration Error = خطا در ثبت نام
Home = صفحه اول
No Zing! account for = این کاربر اکانت زینگ ندارد
Current Games = بازی های فعلی
Create Account = حساب باز کن
More Info = اطلاعات بیشتر
Page = صفحه
Done = انجام شد
Facebook Friend = دوست فیسبوکی
Game Type = نوع بازی
Not Logged In = وارد نشده
Settings = تنظیمات
Gender = جنسیت
Update = به‌روزرسانی
Zing! = زینگ!
Gender = جنسیت
Sign-in with Facebook = ورود از طریق فیسبوک
Male = مرد
Female = زن
No Selection = چیزی انتخاب نشده
Logged in =  وارد شدید
Logged in as: = وارد شد با:
Problem logging in = خطا در هنگام ورود
400 bad request = 400
Try Again = دوباره سعی کنید
Start with player one. = بازی با رقیب شماره یک را شروع کن
Can't Start Game = بازی نمی‌تواند شروع شود
OK = قبول
Ok, I'm Ready = من حاضر هستم
Please pass the device. = دستگاه را به نفر بعدی بدهید
It is time for your opponent to take their turn. Please pass the device to the other player. = حالا نوبت رقیب شماست که بازی کند.  لطفا دستگاه را به نفر بعدی بدهید.
It's a tie = مساوی شد
Player 2 = رقیب ۲
Loading... = بارگذاری...
Quiz = سوال
Thanks for completing the survey = از اینکه نظرسنجی را تکمیل کردید سپاس‌گزاریم
Thanks for leaving feedback = از ارسال پیام برای ما سپاس‌ گزاریم
Please try again. = لطفا مجددا تلاش کنید
Error fetching challenge details = خطا در بارگذاری اطلاعات رقیب
Save = ذخیره
Load More... = بارگذاری موارد بیشتر...
You must have register an account to choose facebook friends = برای بازی با دوستان فیسبوکی اول باید ثبت نام کنید
The many benefits of registration = هنوز ثبت‌نام نکرده‌اید. ثبت‌نام کردن در این برنامه چند فایده دارد، از جمله امکان بازی چند نفره، ثبت امتیاز شما و مقایسه آن با همه کسانی که این بازی را انجام می‌دهند و دریافت سریع آخرین تغییرات در بازی. پیشنهاد می‌کنیم حتما ثبت‌نام کنید.
Multiplayer Game Guide = راهنمای بازی چند نفره
Or = یا
Can't find facebook friends = موفق به پیدا کردن دوستان فیسبوکی شما نشدیم
Submit Feedback = ارسال پیشنهاد/انتقاد
Feedback = باز خورد
Please fill in the feedback form if you wish = لطفا اگر تمایل دارید فرم نظرسنجی را تکمیل کنید
Please fill out the following survey = لطفا اگر تمایل دارید فرم نظرسنجی را تکمیل کنید
No Games = هیچ بازی های
Player 1 = پلیر یکی
WINNER! = برنده!
Skip = بعدا
Turn off music = خاموش کردن موسیقی
Turn on music = روشن کردن موسیقی